9 9
#########
#    #  #
# ##    #
#       #
#       #
#       #
#      ##
#     ###
#########
