12 11
###########
#    #    #
# ##      #
#         #
#         #
#         #
#        ##
#       ###
#  ###### #
#         #
#         #
###########
